NO ./images/NO.xpm
SO ./images/SO.xpm
WE ./images/WE.xpm
EA ./images/EA.xpm
F 255,0,0
C 10,155,20

11111111111111111111111
10000000100111100000001
100000000111000000S0001
10000000001010000010001
10000000000000000000001
11111111111111111111111
