NO ./images/NO.xpm
SO ./images/SO.xpm
WE ./images/WE.xpm
EA ./images/EA.xpm
F 255,0,0
C 10,155,20

11111111111111111111111
10000000000100000000001 1111111111
10000000000110000000001 1000000001
10000000000101000000001 1111111111
10000000100111100000001
10000000E11100000000001
1000000001 100000000001
10000000011100000000001
10000000000000000000001
10000000000000000000001
10000000000010000000001
10000000010010000000001
10000000010010000000001
10000000000010000000001
10000000000000000000001
10000000000000000000001
10000000000000000000001
10000111100000000000001
10000000000000000000001
10000000000000000000001
10000000000000000000001
10000000000000000000001
10000000000000000000001
10000000000000000000001
10000000000000000000001
10000000000000000000001
10000000000000000000001
10000000000000000000001
10000000000000000000001
10000000000000000000001
10000000000000000000001
11111111111111111111111