NO ./images/NO.xpm
SO ./images/SO.xpm
WE ./images/WE.xpm
EA ./images/EA.xpm
F 255,0,0
C 10,88,20

11111111111111111111111
10000000100111100000001
10000000011100000000001
10000000001010000010001
10000000000000000000001
11111111111011111111111
11111111111111111111111
10000000001000000000011
1000000001W100000000001
10000000001000000000011
10000000000000000000001
11111111111111111111111
